11111111111
11111111111
1011000P001
100C0000001
10000CC0001
10C0C11C001
1000CC00C11
111E1111111
11111111111
