1111111111111111111
110P011111111111111
1100011111111111111
11CC0000000C0000111
1111110C0000CCCC111
1111110111111111111
11111000C1111111111
11110C0111111111111
10CCC000000C0000C01
111111111111100C111
100000000C00CC00001
111E111111111111111
1111111111111111111
