111111111111
111111111111
101010P01011
1C0101000C01
1C00C01CC0C1
1C000C0C0101
101110100111
1C011101CC01
1010101010C1
1C01010C0101
10C01010C011
1C0C000C0101
11001E110011
111111111111
111111111111
