11111111111
11111111111
1CCCCPCCCC1
1CCCCCCCCC1
1CCCCCCCCC1
1CCCCCCCCC1
11111E11111
11111111111
